60, 9, 9, 9, 9, 9, 9, 12, 9, 12, 60, 9, 9, 9, 9, 9, 9, 9, 9, 9, 9, 9, 9, 9, 9, 9, 9, 9, 9, 
60, 12, 12, 12, 12, 9, 9, 12, 9, 12, 12, 12, 12, 12, 12, 12, 12, 12, 12, 12, 12, 12, 12, 12, 12, 12, 12, 12, 9, 
60, 12, 9, 9, 12, 9, 9, 12, 9, 9, 9, 9, 9, 9, 9, 9, 9, 9, 9, 9, 9, 9, 9, 9, 9, 9, 9, 12, 9,
9, 12, 9, 9, 12, 12, 12, 12, 9, 9, 9, 9, 9, 9, 9, 9, 9, 9, 9, 9, 9, 9, 9, 9, 9, 9, 9, 12, 9,
9, 12, 9, 9, 9, 9, 9, 9, 9, 12, 12, 12, 12, 12, 12, 168, 168, 9, 12, 12, 12, 12, 12, 12, 12, 12, 12, 12, 9,
9, 12, 9, 9, 9, 9, 9, 9, 9, 12, 168, 9, 9, 9, 12, 9, 9, 9, 12, 9, 9, 9, 9, 9, 9, 9, 9, 9, 9,
9, 12, 9, 9, 9, 9, 9, 9, 9, 12, 9, 9, 9, 9, 12, 9, 9, 9, 12, 9, 9, 9, 9, 9, 9, 9, 9, 141, 9, 
9, 12, 9, 9, 9, 9, 9, 9, 9, 12, 141, 12, 12, 12, 12, 9, 9, 9, 12, 12, 12, 12, 12, 12, 12, 12, 12, 12, 9, 
9, 12, 9, 9, 9, 9, 9, 9, 9, 12, 9, 12, 9, 9, 9, 9, 9, 9, 9, 9, 9, 9, 117, 9, 9, 9, 9, 12, 9, 
9, 12, 9, 9, 9, 9, 9, 9, 9, 12, 9, 12, 9, 9, 9, 9, 9, 9, 9, 9, 9, 9, 9, 9, 9, 9, 9, 12, 9,
9, 12, 120, 9, 9, 9, 9, 9, 9, 12, 9, 12, 9, 9, 9, 9, 9, 9, 9, 9, 9, 9, 9, 9, 9, 9, 9, 12, 9,
9, 12, 12, 12, 12, 12, 12, 12, 12, 12, 117, 12, 12, 12, 12, 12, 12, 12, 12, 12, 12, 12, 12, 12, 12, 12, 12, 12, 9,
9, 9, 9, 9, 9, 9, 9, 9, 9, 9, 9, 9, 9, 9, 9, 9, 9, 9, 9, 9, 9, 9, 9, 9, 9, 9, 9, 9, 9

